***************
*FGGGGGGG******
*GGGGGGGG*GGGG*
*******GG*GG***
*GGGGGGGG*GG***
*GGG****GGGG***
******GGG*GGGG*
*GGGGGGG**G**G*
*G*GGG*GG*GG*G*
*G***********G*
*G*GGGGGG*GGGG*
*G**GG*G**G*GG*
*GGGGG*G**G****
*GGGGG*GGGGGGGS
***************
