FWWWWWWWWWWWWWW
GGGGGGGGGWWWWWW
WGGGGGGGGWGGGGW
WWWWWWWGGWGGWWW
WGGGGGGGGWGGWWW
WGGGWWWWGGGGWWW
WWWWWWGGGWGGGGW
WGGGGGGGWWGWWGW
WGWGGGWGGWGGWGW
WGWWWWWWWWWWWGW
WGWGGGGGGWGGGGW
WGWWGGWGWWGWGGW 
WGGGGGWGWWGWWWW 
WGGGGGWGGGGGGGS
WWWWWWWWWWWWWWW 
